aaeo	Aquifex aeolicus
actiCORYd	Corynebacter diphteriae
actiMYCOt	Mycobacterium tuberculosis
actiSTREc	Streptomyces coelicolor
aful	Archaeoglobus fulgidus
afum	Aspergillus fumigatus
alfaAZOSs	Azospirillum sp.
alfaMAGNm	Magnetospirillum magneticum
alfaNITRh	Nitrobacter hamburgensis
alfaRHODs	Rhodobacter sphaeroides
alfaRICKc	Rickettsia conori
amoACANc	Acanthamoeba castellanii
amoDICTd	Dictyostelium discoideum
amoENTAh	Entamoeba histolytica
amoPAULc	Paulinella chromatophora
aniDROSm	Drosophila melanogaster
aniMONOb	Monosiga brevicollis
aory	Aspergillus oryzae
apiCRYPm	Cryptosporidium muris
apiEIMEt	Eimeria tenella
apiGREGn	Gregarina niphandrodes
apiCHROv	Chromera velia
apiNEOSc	Neospora caninum
apiTHEIe	Theileria equi
apiTOXOg	Toxoplasma gondii
apiVITbr	Vitrella brassicaformis
apiVOROp	Voromonas pontica
archPICRt	Picrophilus torridus
archPYROa	Pyrobaculum aerophilum
archSULFt	Sulfolobus tokodaii
archTHERv	Thermoplasma volcanium
atha	Arabidopsis thaliana
atum	Agrobacterium tumefaciens
bant	Bacillus anthracis
bcidBACTf	Bacteroides fragilis
bcidFLAVc	Flavobacterium columnare
bcidPORPg	Porphyromonas gingivalis
bcidPREVr	Prevotella ruminicola
betaBURKc	Burkholderia cenocepacia
betaCUPRn	Cupriavidus necator
betaRALSs	Ralstonia solanacearum
betaVERMe	Verminephrobacter eiseniae
bmaa	Brugia malayi
bmal	Burkholderia mallei
bsui	Brucella suis
calb	Candida albicans
cbot	Clostridium botulinum
cbur	Coxiella burnetii
cele	Caenorhabditis elegans
cilCONDm	Condylostoma magnum
cilEUPfo	Euplotes focardii
cilFABRs	Fabrea salina
cilFAVta	Favella taraikaensis
cilLITOp	Litonotus pictus
cilPARAt	Paramecium tetraurelia
cilPLATm	Platyophrya macrostoma
cilTETRt	Tetrahymena thermophila
cilTIARf	Tiarina fusus
cimm	Coccidioides immitis
cjej	Campylobacter jejuni
cneg	Cryptococcus neoformans
cper	Clostridium perfringens
cpne	Chlamydophila pneumoniae
cpos	Coccidioides posadasii
crei	Chlamydomonas reinhardtii
crypCRYpa	Cryptomonas paramecium
crypGUILt	Guillardia theta
crypGUIth	Guillardia theta
crypRHOsa	Rhodomonas salina
ctep	Chlorobium tepidum
cyanANABv	Anabaena variabilis
cyanCROCw	Crocosphaera watsonii
cyanCYANp	Cyanothece sp.
cyanLYNGp	Lyngbya sp.
cyanNODUs	Nodularia spumigena
cyanPROCm	Prochlorococcus marinus
cyanSYNEs	Synechococcus sp.
cyanTHERe	Thermosynechococcus elongatus
ddis	Dictyostelium discoideum
deth	Dehalococcoides ethenogenes
dhan	Debaryomyces hansenii
dinALEXa	Alexandrium andersonii
dinALEXc	Alexandrium catenella
dinAMPHc	Amphidinium carterae
dinAMPHm	Amphidinium massartii
dinCERAf	Ceratium fusus
dinCRYPc	Crypthecodinium cohnii
dinDURIb	Durinskia baltica
dinGLENf	Glenodinium foliaceum
dinGYMNc	Gymnodinium catenatum
dinHETro	Heterocapsa rotundata
dinHETtr	Heterocapsa triquestra
dinKARb	Karenia brevis
dinKARmi	Karlodinium micrum
dinKRYPf	Kryptoperidinium foliaceum
dinLINGp	Lingulodinium polyedra
dinNOCTs	Noctiluca scintillans
dinOXYma	Oxyrrhis marina
dinPRORm	Prorocentrum minimum
dinPYROb	Pyrodinium bahamense
dinSYMBs	Symbiodinium sp.
dmel	Drosophila melanogaster
drad	Deinococcus radiodurans
ecab	Equus caballus
ecol	Escherichia coli
egos	Eremothecium gossypii
eugEUGgr	Euglena gracilis
eugEUGlo	Euglena longa
eugEUTc	Eutreptiella gymnastica CCMP1594
eugEUTn	Eutreptiella gymnastica NIES-381
eugLEISm	Leishmania major
eugTRYPb	Trypanosoma brucei
excNAEgr	Naegleria gruberi
excPERco	Percolomonas cosmopolitus
firmBACIa	Bacillus anthracis
firmLISTm	Listeria monocytogenes
firmSTAPa	Staphyllococcus aureus
ftul	Francisella tularensis
funASPEf	Aspergillus fumigatus
funCRYPn	Cryptococcus neoformans
funLACCb	Laccaria bicolor
gamaSHEWb	Shewanella baltica
gamaVIBRc	Vibrio cholerae
gamaYERSp	Yersinia pestis
ggal	Gallus gallus
glauCYApa	Cyanophora paradoxa
glauCYPTg	Cyanoptyche gloeocystis
glauGLOwi	Gloeochaete wittrockiana
grnBATHp	Bathycoccus prasinos
grnCOCCs	Coccomyxa subellipsoidea
grnDUNte	Dunaliella tertiolecta
grnCHLAr	Chlamydomonas reinhardtii
grnCHLOv	Chlorella variabilis
grnMICRp	Micromonas pusilla
grnOSTRt	Ostreococcus tauri
grnPOLYp	Polytomella parva
grnPYRam	Pyramimonas amylifera
grnPYRpa	Pyramimonas parkeae
grnVOLVc	Volvox carteri f. nagariensis
gsul	Geobacter sulfurreducens
halo	Halobacterium sp.
haptEMILh	Emiliania huxleyi
haptPLEUc	Pleurochrysis carterae
haptPRYMp	Prymnesium parvum
hsap	Homo sapiens
hwal	Haloquadratum walsbyi
chlaBIGna	Bigelowiella natans
chlaLOTam	Lotharella amoebiformis
chlaLOTgl	Lotharella globosa
chlaLOTHs	Lotharella sp.
chlaLOToc	Lotharella oceanica
chryDINOB	Dinobryon sp.
chryHETak	Heterosigma akashiwo
chryCHATs	Chattonella subsalsa
chryOCHRO	Ochromonas sp.
chryPTERd	Pteridomonas danica
chryVAUCH	Vaucheria litorea
klac	Kluyveromyces lactis
kytARABt	Arabidopsis thaliana
kytORYZs	Oryza sativa Japonica
kytPHYSp	Physcomitrella patens
kytSELAm	Selaginella moellendorffii
lmon	Listeria monocytogenes
mjan	Methanocaldococcus jannaschii
mlep	Mycobacterium leprae
mmar	Methanococcus maripaludi
mmul	Macaca mulatta
mmus	Mus musculus
msed	Metallosphaera sedula
mtub	Mycobacterium tuberculosis
ncra	Neurospora crassa
oana	Ornithorhynchus anatinus
oomPHYra	Phytophtora ramorum
oomPYTHu	Pythium ultimum
osat	Oryza sativa Japonica
perkPmari	Perkinsus marinus
pfal	Plasmodium falciparum
ppat	Physcomitrella patens
rbal	Rhodopirellula baltica
redCYANm	Cyanidioschyzon merolae
redERYTa	Erythrolobus australicus
redERYTm	Erythrolobus madagascarensis
redGALDs	Galdieria sulphuraria
redCHONc	Chondrus crispus
redMADAe	Madagascaria erythrocladoides
redPORae	Porphyridium aerugineum
redPORpu	Porphyra purpurea
redRHOma	Rhodella maculata
redRHSOm	Rhodosorus marinus
redTIMSo	Timspurckia oligopyrenoides
rhiAMMOs	Ammonia sp.
rhiELPHm	Elphidium margitaceum
rhiMINch	Minchinia chitonis
rhiPARTg	Partenskyella glossopodia
rhiPLASb	Plasmodiophora brassicae
rhiROSAs	Rosalina sp.
rhiSORIs	Sorites sp.
rnor	Rattus norvegicus
rsol	Ralstonia solanacearum
saur	Staphylococcus aureus
scer	Saccharomyces cerevisiae
sent	Salmonella enterica
sfle	Shigella flexneri
sman	Schistosoma mansoni
spne	Streptococcus pneumoniae
spom	Schizosaccharomyces pombe
ssol	Sulfolobus solfataricus
strAPLAs	Aplanochytrium stocchinoi
strAURAl	Aurantiochytrium limacinum
strAUREa	Aureococcus anophagefferens
strCAFca	Cafeteria Caron
strCAFro	Cafeteria roenbergensis
strECTsi	Ectocarpus siliculosus
strNANNg	Nannochloropsis gaditana
strNANNO	Nannochloropsis gaditana B-31
strPHAtr	Phaeodactylum tricornutum
strSKEma	Skeletonema marinoi
strTHAps	Thalassiosira pseudonana
strTHRAs	Thraustochytrium sp.
syne	Synechococcus sp.
tbru	Trypanosoma brucei
tcru	Trypanosoma cruzi
tgon	Toxoplasma gondii
tmar	Thermotoga maritima
tpal	Treponema pallidum
tvol	Thermoplasma volcanium
vcho	Vibrio cholerae
wend	Wolbachia endosymbiont
wsuc	Wolinella succinogenes
ylip	Yarrowia lipolytica
ypes	Yersinia pestis
