Acanthamoeba	Amoebozoa_Discosea
Acanthoeca	Opisthokonta_Choanoflagellida
Akashiwo	SAR-Dinophyta_Gymnodiniales
Albugo	SAR-Stramenopila_Oomycetes
Alexandrium	SAR-Dinophyta_Gonyaulacales
Amborella	Viridiplantae_Streptophyta
Ammonia	SAR-Rhizaria_Foraminifera
Amoebophrya	SAR-Dinophyta_Syndiniales
Amorphochlora	SAR-Rhizaria_Cercozoa_Chlorarachniophyceae
Amphidinium	SAR-Dinophyta_Gymnodiniales
Amphiprora	SAR-Stramenopila_Bacillariophyta_Bacillariophyceae
Amphora	SAR-Stramenopila_Bacillariophyta_Bacillariophyceae
Angomonas	Euglenozoa_Kinetoplastida
Anolis	Opisthokonta_Metazoa_Vertebrata
Anophryoides	SAR-Ciliophora_Oligohymenophorea
Aphanomyces	SAR-Stramenopila_Oomycetes
Aplanochytrium	SAR-Stramenopila_Labyrinthulomycetes
Arabidopsis	Viridiplantae_Streptophyta
Aristerostoma	SAR-Ciliophora_Oligohymenophorea
Asterionellopsis	SAR-Stramenopila_Bacillariophyta_Fragilariophyceae
Astrosyne	SAR-Stramenopila_Bacillariophyta_Fragilariophyceae
Attheya	SAR-Stramenopila_Bacillariophyta_Coscinodiscophyceae
Aulacoseira	SAR-Stramenopila_Bacillariophyta_Coscinodiscophyceae
Aurantiochytrium	SAR-Stramenopila_Labyrinthulomycetes
Aureococcus	SAR-Stramenopila_Pelagophyceae
Aureoumbra	SAR-Stramenopila_Pelagophyceae
Azadinium	SAR-Dinophyta_Gonyaulacales
Bathycoccus	Viridiplantae_Chlorophyta_Mamiellophyceae
Bicosoecida	SAR-Stramenopila_Bicosoecida
Bigelowiella	SAR-Rhizaria_Cercozoa_Chlorarachniophyceae
Blastocystis	SAR-Stramenopila_basal
Blepharisma	SAR-Ciliophora_Heterotrichea
Bodo	Euglenozoa_Kinetoplastida
Bolidomonas	SAR-Stramenopila_Bolidophyceae
Brandtodinium	SAR-Dinophyta_Peridiniales
Caenorhabditis	Opisthokonta_Metazoa_Nematoda
Cafeteria	SAR-Stramenopila_Bicosoecida
Calcidiscus	Haptophyta_Coccolithales
Candida	Opisthokonta_Fungi_Ascomycota
Capitella	Opisthokonta_Metazoa_Protostomia
Caulerpa	Viridiplantae_Chlorophyta_Ulvophyceae
Crassostrea	Opisthokonta_Metazoa_Protostomia
Capsaspora	Opisthokonta_basal
Chaetoceros	SAR-Stramenopila_Bacillariophyta_Coscinodiscophyceae
Chaetoceros cf. neogracile	SAR-Stramenopila_Bacillariophyta_Coscinodiscophyceae
Chattonella	SAR-Stramenopila_Raphidophyceae
Chlamydomonas	Viridiplantae_Chlorophyta_Chlorophyceae
Chlorarachnion	SAR-Rhizaria_Cercozoa_Chlorarachniophyceae
Chlorella	Viridiplantae_Chlorophyta_Trebouxiophyceae
Chondrus	Rhodophyta_Florideophyceae
Chromera	SAR-Apicomplexa_Chrompodellida
Chromulina	SAR-Stramenopila_Chrysophyceae
Chroomonas	Cryptophyta_Pyrenomonadales
Chrysochromulina	Haptophyta_Prymnesiales
Chrysoculter	Haptophyta_incertae sedis
Chrysocystis	SAR-Stramenopila_Pelagophyceae
Chrysoreinhardia	SAR-Stramenopila_Pelagophyceae
Climacostomum	SAR-Ciliophora_Heterotrichea
Coccolithus	Haptophyta_Coccolithales
Coccomyxa	Viridiplantae_Chlorophyta_Trebouxiophyceae
Compsopogon	Rhodophyta_Compsopogonophyceae
Condylostoma	SAR-Ciliophora_Heterotrichea
Corethron	SAR-Stramenopila_Bacillariophyta_Coscinodiscophyceae
Coscinodiscus	SAR-Stramenopila_Bacillariophyta_Coscinodiscophyceae
Craspedostauros	SAR-Stramenopila_Bacillariophyta_Bacillariophyceae
Crustomastix	Viridiplantae_Chlorophyta_Mamiellophyceae
Crypthecodinium	SAR-Dinophyta_Gonyaulacales
Cryptococcus	Opisthokonta_Fungi_Basidiomycota
Cryptomonas	Cryptophyta_Cryptomonadales
Cyanidioschyzon	Rhodophyta_Bangiophyceae
Cyanoptyche	Glaucocystophyta
Cyclophora	SAR-Stramenopila_Bacillariophyta_Fragilariophyceae
Cyclotella	SAR-Stramenopila_Bacillariophyta_Coscinodiscophyceae
Cylindrotheca	SAR-Stramenopila_Bacillariophyta_Bacillariophyceae
Dactyliosolen	SAR-Stramenopila_Bacillariophyta_Coscinodiscophyceae
Daphnia	Opisthokonta_Metazoa_Arthropoda
Debaryomyces	Opisthokonta_Fungi_Saccharomycetes
Detonula	SAR-Stramenopila_Bacillariophyta_Coscinodiscophyceae
Dictyocha	SAR-Stramenopila_Dictyochophyceae
Dictyostelium	Amoebozoa_Mycetozoa
Dinobryon	SAR-Stramenopila_Chrysophyceae
Dinophysis	SAR-Dinophyta_Dinophysiales
Ditylum	SAR-Stramenopila_Bacillariophyta_Mediophyceae
Dolichomastix	Viridiplantae_Chlorophyta_Mamiellophyceae
Dunaliella	Viridiplantae_Chlorophyta_Chlorophyceae
Durinskia	SAR-Dinophyta_Peridiniales
Elphidium	SAR-Rhizaria_Foraminifera
Emiliania	Haptophyta_Isochrysidales
Entamoeba	Amoebozoa_Archamoebae
Entomoneis	SAR-Stramenopila_Bacillariophyta_Bacillariophyceae
Erythrolobus	Rhodophyta_Bangiophyceae
Eucampia	SAR-Stramenopila_Bacillariophyta_Mediophyceae
Euplotes	SAR-Ciliophora_Spirotrichea
Eutreptiella	Euglenozoa_Euglenophyta
Eutreptiella gymnastica NIES-381	Euglenozoa_Euglenophyta
Exanthemachrysis	Haptophyta_Pavlovales
Exaiptasia	Opisthokonta_Metazoa_Cnidaria
Extubocellulus	SAR-Stramenopila_Bacillariophyta_Mediophyceae
Fabrea	SAR-Ciliophora_Heterotrichea
Favella	SAR-Ciliophora_Spirotrichea
Fibrocapsa	SAR-Stramenopila_Raphidophyceae
Filamoeba	Amoebozoa_Tubulinea
Florenciella	SAR-Stramenopila_Dictyochophyceae
Fragilariopsis	SAR-Stramenopila_Bacillariophyta_Fragilariophyceae
Galdieria	Rhodophyta_Bangiophyceae
Gambierdiscus	SAR-Dinophyta_Gonyaulacales
Geminigera	Cryptophyta_Pyrenomonadales
Gephyrocapsa	Haptophyta_Isochrisidales
Gloeochaete	Glaucocystophyta
Glycine	Viridiplantae_Streptophyta
Goniomonas	Cryptophyta_Cryptomonadales
Gonium	Viridiplantae_Chlorophyta_Chlorophyceae
Gonyaulax	SAR-Dinophyta_Gonyaulacales
Grammatophora	SAR-Stramenopila_Bacillariophyta_Fragilariophyceae
Guillardia	Cryptophyta_Pyrenomonadales
Gymnochlora	SAR-Rhizaria_Cercozoa_Chlorarachniophyceae
Gymnodinium	SAR-Dinophyta_Gymnodiniales
Gyrodinium	SAR-Dinophyta_Gymnodiniales
Hanusia	Cryptophyta_Pyrenomonadales
Haptolina	Haptophyta_Prymnesiales
Helicosporidium	Viridiplantae_Chlorophyta_Trebouxiophyceae
Helicotheca	SAR-Stramenopila_Bacillariophyta_Mediophyceae
Helobdella	Opisthokonta_Metazoa_Annelida
Hemiselmis	Cryptophyta_Cryptomonadales
Heterocapsa	SAR-Dinophyta_Peridiniales
Heterosigma	SAR-Stramenopila_Raphidophyceae
Hordeum	Viridiplantae_Streptophyta
Hyaloperonospora	SAR-Stramenopila_Oomycetes
Ichthyophthirius	SAR-Ciliophora_Oligohymenophorea
Imantonia	Haptophyta_Prymnesiales
Isochrysis	Haptophyta_Isochrysidales
Karenia	SAR-Dinophyta_Gymnodiniales
Karlodinium	SAR-Dinophyta_Gymnodiniales
Klebsormidium	Viridiplantae_Streptophyta
Kluyveromyces	Opisthokonta_Fungi_Ascomycota
Kryptoperidinium	SAR-Dinophyta_Peridiniales
Lankesteria	SAR-Apicomplexa_Gregarinasina
Leishmania	Euglenozoa_Kinetoplastida
Leptocylindrus	SAR-Stramenopila_Bacillariophyta_Coscinodiscophyceae
Lessardia	SAR-Dinophyta_Peridiniales
Licmophora	SAR-Stramenopila_Bacillariophyta_Fragilariophyceae
Lingulodinium	SAR-Dinophyta_Gonyaulacales
Lingula	Opisthokonta_Metazoa_Protostomia
Litonotus	SAR-Ciliophora_Litostomatea
Loa loa.Loa	Opisthokonta_Metazoa_Nematoda
Lotharella	SAR-Rhizaria_Cercozoa_Chlorarachniophyceae
Lottia	Opisthokonta_Metazoa_Mollusca
Madagascaria	Rhodophyta_Compsopogonophyceae
Mallomonas	SAR-Stramenopila_Synurophyceae
Mantoniella	Viridiplantae_Chlorophyta_Mamiellophyceae
Mayorella	Amoebozoa_Discosea
Mesodinium	SAR-Ciliophora_Litostomatea
Micromonas	Viridiplantae_Chlorophyta_Mamiellophyceae
Minchinia	SAR-Rhizaria_Cercozoa_Ascetosporea
Minutocellus	SAR-Stramenopila_Bacillariophyta_Mediophyceae
Mizuhopecten	Opisthokonta_Metazoa_Protostomia
Moneuplotes	SAR-Ciliophora_Spirotrichea
Monosiga	Opisthokonta_basal
Myrionecta	SAR-Ciliophora_Litostomatea
Nannochloropsis	SAR-Stramenopila_Eustigmatophyceae
Nematostella	Opisthokonta_Metazoa_Cnidaria
Neobodo	Euglenozoa_Kinetoplastida
Neoceratium	SAR-Dinophyta_Gonyaulacales
Nephroselmis	Viridiplantae_Chlorophyta_Nephroselmidophyceae
Neurospora	Opisthokonta_Fungi_Ascomycota
Nitzschia	SAR-Stramenopila_Bacillariophyta_Bacillariophyceae
Noctiluca	SAR-Dinophyta_Noctilucales
Norrisiella	SAR-Rhizaria_Cercozoa_Chlorarachniophyceae
Ochromonas	SAR-Stramenopila_Chrysophyceae
Odontella	SAR-Stramenopila_Bacillariophyta_Mediophyceae
Oryza	Viridiplantae_Streptophyta
Ostreococcus	Viridiplantae_Chlorophyta_Mamiellophyceae
Oxyrrhis	SAR-Dinophyta_Oxyrrhinales
Palpitomonas	Cryptophyta_basal taxon
Paramecium	SAR-Ciliophora_Oligohymenophorea
Paramoeba	Amoebozoa_Discosea
Paraphysomonas	SAR-Stramenopila_Chrysophyceae
Partenskyella	SAR-Rhizaria_Cercozoa_Chlorarachniophyceae
Pavlova	Haptophyta_Pavlovales
Pelagococcus	SAR-Stramenopila_Pelagophyceae
Pelagodinium	SAR-Dinophyta_Suessiales
Pelagomonas	SAR-Stramenopila_Pelagophyceae
Percolomonas	Heterolobosea
Peridinium	SAR-Dinophyta_Peridiniales
Perkinsus	SAR-Dinophyta_Perkinsida
Pessonella	Amoebozoa_Discosea
Phaeocystis	Haptophyta_Phaeocystales
Phaeomonas	SAR-Stramenopila_Pinguiophyceae
Physcomitrella	Viridiplantae_Streptophyta
Phytomonas	Euglenozoa_Kinetoplastida
Phytophthora	SAR-Stramenopila_Oomycetes
Picochlorum	Viridiplantae_Chlorophyta_Trebouxiophyceae
Picocystis	Viridiplantae_Chlorophyta_prasinophyteVII
Pinguiococcus	SAR-Stramenopila_Pinguiophyceae
Plasmodiophora	SAR-Rhizaria_Cercozoa_Plasmodiophorida
Platyophrya	SAR-Ciliophora_Colpodea
Pleurochrysis	Haptophyta_Coccolithales
Polarella	SAR-Dinophyta_Suessiales
Polyblepharides	Viridiplantae_Chlorophyta_Pyramimonadales
Polysphondylium	Amoebozoa_Mycetozoa
Polytomella	Viridiplantae_Chlorophyta_Chlorophyceae
Porphyridium	Rhodophyta_Bangiophyceae
Prasinococcus	Viridiplantae_Chlorophyta_Prasinococcales
Prasinoderma	Viridiplantae_Chlorophyta_Prasinococcales
Proboscia	SAR-Stramenopila_Bacillariophyta_Coscinodiscophyceae
Prorocentrum	SAR-Dinophyta_Prorocentrales
Proteomonas	Cryptophyta_Pyrenomonadales
Protoceratium	SAR-Dinophyta_Gonyaulacales
Protocruzia	SAR-Ciliophora_Spirotrichea
Prymnesium	Haptophyta_Prymnesiales
Pseudo-nitzschia	SAR-Stramenopila_Bacillariophyta_Bacillariophyceae
Pseudocohnilembus	SAR-Ciliophora_Oligohymenophorea
Pseudokeronopsis	SAR-Ciliophora_Spirotrichea
Pseudopedinella	SAR-Stramenopila_Dictyochophyceae
Pteridomonas	SAR-Stramenopila_Dictyochophyceae
Pterosperma	Viridiplantae_Chlorophyta_Pyramimonadales
Puccinia	Opisthokonta_Fungi_Basidiomycota
Pycnococcus	Viridiplantae_Chlorophyta_Pycnococcaceae
Pyramimonas	Viridiplantae_Chlorophyta_Pycnococcaceae
Pyramimonas	Viridiplantae_Chlorophyta_Pyramimonadales
Pyrocystis	SAR-Dinophyta_Pyrocystales
Pyrodinium	SAR-Dinophyta_Gonyaulacales
Pythium	SAR-Stramenopila_Oomycetes
Ramazzottius	Opisthokonta_Metazoa_Bilateria
Raphidocelis	Viridiplantae_Chlorophyta_Chlorophyceae
Reticulomyxa	SAR-Rhizaria_Foraminifera
Rhizochromulina	SAR-Stramenopila_Dictyochophyceae
Rhizosolenia	SAR-Stramenopila_Bacillariophyta_Coscinodiscophyceae
Rhodella	Rhodophyta_Rhodellophyceae
Rhodomonas	Cryptophyta_Pyrenomonadales
Rhodosorus	Rhodophyta_Stylonematophyceae
Rosalina	SAR-Rhizaria_Foraminifera
Saccharomyces	Opisthokonta_Fungi_Ascomycota
Salpingoeca	Opisthokonta_basal
Saprolegnia	SAR-Stramenopila_Oomycetes
Sarcinochrysis	SAR-Stramenopila_Pelagophyceae
Schistosoma	Opisthokonta_Metazoa_Platyhelminthes
Schizochytrium	SAR-Stramenopila_Labyrinthulomycetes
Schizosaccharomyces	Opisthokonta_Fungi_Ascomycota
Schmidingerella	SAR-Ciliophora_Spirotrichea
Scrippsiella	SAR-Dinophyta_Peridiniales
Scyphosphaera	Haptophyta_Coccosphaerales
Selaginella	Viridiplantae_Streptophyta
Sexangularia	Amoebozoa_Tubulinea
Skeletonema	SAR-Stramenopila_Bacillariophyta_Coscinodiscophyceae
Solanum	Viridiplantae_Streptophyta
Sorites	SAR-Rhizaria_Foraminifera
Spumella	SAR-Stramenopila_Chrysophyceae
Stauroneis	SAR-Stramenopila_Bacillariophyta_Bacillariophyceae
Staurosira	SAR-Stramenopila_Bacillariophyta_Fragilariophyceae
Stentor	SAR-Ciliophora_Heterotrichea
Stephanopyxis	SAR-Stramenopila_Bacillariophyta_Coscinodiscophyceae
Stereomyxa	Amoebozoa
Stichococcus	Viridiplantae_Chlorophyta_Trebouxiophyceae
Striatella	SAR-Stramenopila_Bacillariophyta_Fragilariophyceae
Strigomonas	Euglenozoa_Kinetoplastida
Strombidinopsis	SAR-Ciliophora_Spirotrichea
Strombidium	SAR-Ciliophora_Spirotrichea
Strongylocentrotus	Opisthokonta_Metazoa_Echinodermata
Stygamoeba	Amoebozoa_Discosea
Symbiodinium	SAR-Dinophyta_Suessiales
Synchroma	SAR-Stramenopila_Synchromophyceae
Synedropsis	SAR-Stramenopila_Bacillariophyta_Fragilariophyceae
Tetrahymena	SAR-Ciliophora_Oligohymenophorea
Tetraselmis	Viridiplantae_Chlorophyta_Chlorodendrophyceae
Thalassionema	SAR-Stramenopila_Bacillariophyta_Fragilariophyceae
Thalassiosira	SAR-Stramenopila_Bacillariophyta_Coscinodiscophyceae
Thalassiothrix	SAR-Stramenopila_Bacillariophyta_Fragilariophyceae
Thoracosphaera	SAR-Dinophyta_Peridiniales
Thraustochytrium	SAR-Stramenopila_Labyrinthulomycetes
Tiarina	SAR-Ciliophora_Protostomatea
Timspurckia	Rhodophyta_Bangiophyceae
Togula	SAR-Dinophyta_Gymnodiniales
Triceratium	SAR-Stramenopila_Bacillariophyta_Mediophyceae
Trichoplax	Opisthokonta_Metazoa_Placozoa
Trichosphaerium	Amoebozoa_Discosea
Tryblionella	SAR-Stramenopila_Bacillariophyta_Bacillariophyceae
Uronema	SAR-Ciliophora_Oligohymenophorea
Vannella	Amoebozoa_Discosea
Vaucheria	SAR-Stramenopila_PX clade_Xanthophyceae
Vexillifera	Amoebozoa_Discosea
Vitrella	SAR-Apicomplexa_Chrompodellida
Volvox	Viridiplantae_Chlorophyta_Chlorophyceae
Yarrowia	Opisthokonta_Fungi_Ascomycota
Zea	Viridiplantae_Streptophyta
Acaryochloris	Bacteria_Cyanobacteria
Acidilobus	Archaea_TACK
Acidiphilium	Bacteria_Alphaproteobacteria
Aciduliprofundum	Archaea_Euryarchaeota
Actinoplanes	Bacteria_Actinobacteria
Agrobacterium	Bacteria_Alphaproteobacteria
Akkermansia	Bacteria_PVC group_Verrucomicrobia
Alkalilimnicola	Bacteria_Gammaproteobacteria
Alteromonas	Bacteria_Gammaproteobacteria
Aminobacterium	Bacteria_Synergistia
Anabaena	Bacteria_Cyanobacteria
Anaerofustis	Bacteria_Firmicutes
Anaerolinea	Bacteria_Chloroflexi
Anaerophaga	Bacteria_FCB group_Bacteroidetes
Aquifex	Bacteria_Aquificae
Archaeoglobus	Archaea_Euryarchaeota
Arcobacter	Bacteria_Epsilonproteobacteria
Arsenicibacter	Bacteria_FCB group_Bacteroidetes
Aspergillus	Opisthokonta_Fungi_Ascomycota
Azospira	Bacteria_Betaproteobacteria
Azospirillum	Bacteria_Alphaproteobacteria
Azotobacter	Bacteria_Gammaproteobacteria
Bacillus	Bacteria_Firmicutes
Bacteriovorax	Bacteria_Proteobacteria_Oligoflexia
Bacteroides	Bacteria_FCB group_Bacteroidetes
Bartonella	Bacteria_Alphaproteobacteria
Bdellovibrio	Bacteria_Proteobacteria_Oligoflexia
Borrelia	Bacteria_Spirochaetes
Brachyspira	Bacteria_Spirochaetes
Bradyrhizobium	Bacteria_Alphaproteobacteria
Brevibacillus	Bacteria_Firmicutes
Brucella	Bacteria_Alphaproteobacteria
Brugia	Opisthokonta_Metazoa_Eumetazoa_Bilateria
Burkholderia	Bacteria_Betaproteobacteria
Caldicellulosiruptor	Bacteria_Firmicutes
Caldilinea	Bacteria_Chloroflexi
Caldisericum	Bacteria_Caldiserica
Caldisphaera	Archaea_TACK
Calliarthron	Rhodophyta_Florideophyceae
Caloramator	Bacteria_Firmicutes
Caminibacter	Bacteria_Epsilonproteobacteria
Campylobacter	Bacteria_Epsilonproteobacteria
Cardiobacterium	Bacteria_Gammaproteobacteria
Cellvibrio	Bacteria_Gammaproteobacteria
Ceratium	SAR-Dinophyta_Gonyaulacales
Chlorobium	Bacteria_FCB group_Chlorobi
Chloroflexus	Bacteria_Chloroflexi
Chromerida	SAR-Apicomplexa_Chromerida
Chroococcidiopsis	Bacteria_Cyanobacteria
Chryseobacterium	Bacteria_FCB group_Bacteroidetes
Chthoniobacter	Bacteria_PVC group_Verrucomicrobia
Ciona	Opisthokonta_Metazoa_Eumetazoa_Bilateria
Citromicrobium	Bacteria_Alphaproteobacteria
Clostridiales	Bacteria_Firmicutes
Clostridium	Bacteria_Firmicutes
Coccidioides	Opisthokonta_Fungi_Ascomycota
Coprococcus	Bacteria_Firmicutes
Coraliomargarita	Bacteria_PVC group_Verrucomicrobia
Corallococcus	Bacteria_Deltaproteobacteria
Coxiella	Bacteria_Gammaproteobacteria
Crinalium	Bacteria_Cyanobacteria
Crocosphaera	Bacteria_Cyanobacteria
Cryptosporidium	SAR-Apicomplexa_Coccidia
Cupriavidus	Bacteria_Betaproteobacteria
Cyanobium	Bacteria_Cyanobacteria
Cyanophora	Glaucocystophyta
Cyanothece	Bacteria_Cyanobacteria
Cytophaga	Bacteria_FCB group_Bacteroidetes
Dehalococcoides	Bacteria_Chloroflexi
Deinococcus	Bacteria_Deinococcus
delta	Opisthokonta_Metazoa_Eumetazoa_Bilateria
Desulfarculus	Bacteria_Deltaproteobacteria
Desulfitobacterium	Bacteria_Firmicutes
Desulfobacca	Bacteria_Deltaproteobacteria
Desulfobacterium	Bacteria_Deltaproteobacteria
Desulfocapsa	Bacteria_Deltaproteobacteria
Desulfococcus	Bacteria_Deltaproteobacteria
Desulfohalobium	Bacteria_Deltaproteobacteria
Desulfomicrobium	Bacteria_Deltaproteobacteria
Desulfomonile	Bacteria_Deltaproteobacteria
Desulfonispora	Bacteria_Firmicutes
Desulfotomaculum	Bacteria_Firmicutes
Desulfurella	Bacteria_Deltaproteobacteria
Desulfurivibrio	Bacteria_Deltaproteobacteria
Desulfuromonas	Bacteria_Deltaproteobacteria
Dethiosulfovibrio	Bacteria_Synergistia
Drosophila	Opisthokonta_Metazoa_Eumetazoa_Bilateria
Ectocarpus	SAR-Stramenopila_PX clade_Phaeophyceae_Ectocarpales
Eimeria	SAR-Apicomplexa_Coccidia
Elusimicrobium	Bacteria_Elusimicrobia
Enterobacter	Bacteria_Gammaproteobacteria
Enterococcus	Bacteria_Firmicutes
Equus	Opisthokonta_Metazoa_Eumetazoa_Bilateria
Eremothecium	Opisthokonta_Fungi_Ascomycota
Erythrobacter	Bacteria_Alphaproteobacteria
Escherichia	Bacteria_Gammaproteobacteria
Eubacteriaceae	Bacteria_Firmicutes
Eubacterium	Bacteria_Firmicutes
Euglena	Euglenozoa_Euglenophyta
Ferroplasma	Archaea_Euryarchaeota
Fibrobacter	Bacteria_FCB group
Fischerella	Bacteria_Cyanobacteria
Flavobacterium	Bacteria_FCB group_Bacteroidetes
Flectobacillus	Bacteria_FCB group_Bacteroidetes
Francisella	Bacteria_Gammaproteobacteria
Frankia	Bacteria_Actinobacteria
Fucus	SAR-Stramenopila_PX clade_Phaeophyceae_Fucales
Galbibacter	Bacteria_FCB group_Bacteroidetes
Gallus	Opisthokonta_Metazoa_Eumetazoa_Bilateria
Gasterosteus	Opisthokonta_Metazoa_Eumetazoa_Bilateria
Geoalkalibacter	Bacteria_Deltaproteobacteria
Geobacter	Bacteria_Deltaproteobacteria
Glaciecola	Bacteria_Gammaproteobacteria
Glenodinium	SAR-Dinophyta_Peridiniales
Gloeobacter	Bacteria_Cyanobacteria
Gloeocapsa	Bacteria_Cyanobacteria
Gluconacetobacter	Bacteria_Alphaproteobacteria
Gracilaria	Rhodophyta_Florideophyceae
Gregarina	SAR-Apicomplexa_Gregarinasina
Haliscomenobacter	Bacteria_FCB group_Bacteroidetes
Halobacterium	Archaea_Euryarchaeota
Halomonas	Bacteria_Gammaproteobacteria
Haloquadratum	Archaea_Euryarchaeota
Halostagnicola	Archaea_Euryarchaeota
Halovivax	Archaea_Euryarchaeota
Hippea	Bacteria_Deltaproteobacteria
Homo	Opisthokonta_Metazoa_Vertebrata
Hydrocarboniphaga	Bacteria_Gammaproteobacteria
Hydrogenivirga	Bacteria_Aquificae
Hymenobacter	Bacteria_FCB group_Bacteroidetes
Hyphomonas	Bacteria_Alphaproteobacteria
Idiomarina	Bacteria_Gammaproteobacteria
Ilumatobacter	Bacteria_Actinobacteria
Isosphaera	Bacteria_PVC group_Planctomycetes
Kangiella	Bacteria_Gammaproteobacteria
Kosmotoga	Bacteria_Thermotogae
Kyrpidia	Bacteria_Firmicutes
Laccaria	Opisthokonta_Fungi_Basidiomycota
Laminaria	SAR-Stramenopila_PX clade_Phaeophyceae
Lautropia	Bacteria_Betaproteobacteria
Legionella	Bacteria_Gammaproteobacteria
Leifsonia	Bacteria_Actinobacteria
Lentisphaera	Bacteria_PVC group
Leptolyngbya	Bacteria_Cyanobacteria
Leptonema	Bacteria_Spirochaetes
Leptospira	Bacteria_Spirochaetes
Leptospirillum	Bacteria_Nitrospirae
Leptotrichia	Bacteria_Fusobacteria
Listeria	Bacteria_Firmicutes
Lyngbya	Bacteria_Cyanobacteria
Macaca	Opisthokonta_Metazoa_Vertebrata
Magnetococcus	Bacteria_Alphaproteobacteria
Magnetospirillum	Bacteria_Alphaproteobacteria
Mamiellaceae	Viridiplantae_Chlorophyta_prasinophytes_Mamiellophyceae
Marinithermus	Bacteria_Deinococcus
Marinitoga	Bacteria_Thermotogae
Marinobacter	Bacteria_Gammaproteobacteria
Marinobacterium	Bacteria_Gammaproteobacteria
Megamonas	Bacteria_Firmicutes
Meiothermus	Bacteria_Deinococcus
Metallosphaera	Archaea_TACK
Methanobrevibacter	Archaea_Euryarchaeota
Methanocaldococcus	Archaea_Euryarchaeota
Methanocella	Archaea_Euryarchaeota
Methanococcoides	Archaea_Euryarchaeota
Methanococcus	Archaea_Euryarchaeota
Methanoculleus	Archaea_Euryarchaeota
Methanofollis	Archaea_Euryarchaeota
Methanomassiliicoccus	Archaea_Euryarchaeota
Methanopyrus	Archaea_Euryarchaeota
Methanoregula	Archaea_Euryarchaeota
Methanosarcina	Archaea_Euryarchaeota
Methanosphaerula	Archaea_Euryarchaeota
Methanotorris	Archaea_Euryarchaeota
Methylacidiphilum	Bacteria_PVC group_Verrucomicrobia
Methylophaga	Bacteria_Gammaproteobacteria
Microbacterium	Bacteria_Actinobacteria
Microcoleus	Bacteria_Cyanobacteria
Microcystis	Bacteria_Cyanobacteria
Micromonospora	Bacteria_Actinobacteria
Mogibacterium	Bacteria_Firmicutes
Monodelphis	Opisthokonta_Metazoa_Vertebrata
Morganella	Bacteria_Gammaproteobacteria
Motiliproteus	Bacteria_Gammaproteobacteria
Muricauda	Bacteria_FCB group_Bacteroidetes
Mus	Opisthokonta_Metazoa_Vertebrata
Mycobacterium	Bacteria_Actinobacteria
Myxococcus	Bacteria_Deltaproteobacteria
Naegleria	Heterolobosea
Natronomonas	Archaea_Euryarchaeota
Neoparamoeba	Amoebozoa_Discosea
Neospora	SAR-Apicomplexa_Coccidia
Nitratiruptor	Bacteria_Epsilonproteobacteria
Nitrobacter	Bacteria_Alphaproteobacteria
Nitrosococcus	Bacteria_Gammaproteobacteria
Nitrososphaera	Archaea_TACK
Nitrospira	Bacteria_Nitrospirae
Nocardioides	Bacteria_Actinobacteria
Nodularia	Bacteria_Cyanobacteria
Nostoc	Bacteria_Cyanobacteria
Oceanibaculum	Bacteria_Alphaproteobacteria
Oceanithermus	Bacteria_Deinococcus
Odoribacter	Bacteria_FCB group_Bacteroidetes
Oenococcus	Bacteria_Firmicutes
Oligotropha	Bacteria_Alphaproteobacteria
Opitutus	Bacteria_PVC group_Verrucomicrobia
Orientia	Bacteria_Alphaproteobacteria
Ornithobacterium	Bacteria_FCB group_Bacteroidetes
Ornithorhynchus	Opisthokonta_Metazoa_Vertebrata
Oscillatoria	Bacteria_Cyanobacteria
Oscillochloris	Bacteria_Chloroflexi
Palaeococcus	Archaea_Euryarchaeota
Pantoea	Bacteria_Gammaproteobacteria
Parachlamydia	Bacteria_PVC group_Chlamydiae
Parasutterella	Bacteria_Betaproteobacteria
Parvibaculum	Bacteria_Alphaproteobacteria
Paulinella	SAR-Rhizaria_Cercozoa
Pedosphaera	Bacteria_PVC group_Verrucomicrobia
Pelagibacterium	Bacteria_Alphaproteobacteria
Pelobacter	Bacteria_Deltaproteobacteria
Pelosinus	Bacteria_Firmicutes
Persephonella	Bacteria_Aquificae
Phaeodactylum	SAR-Stramenopila_Bacillariophyta_Bacillariophyceae
Phaeospirillum	Bacteria_Alphaproteobacteria
Photobacterium	Bacteria_Gammaproteobacteria
Phycisphaera	Bacteria_PVC group_Planctomycetes
Picrophilus	Archaea_Euryarchaeota
Pirellula	Bacteria_PVC group_Planctomycetes
Plasmodium	SAR-Apicomplexa
Polymorphum	Bacteria_Alphaproteobacteria
Porphyra	Rhodophyta_Bangiophyceae
Porphyromonas	Bacteria_FCB group_Bacteroidetes
Prevotella	Bacteria_FCB group_Bacteroidetes
Prochlorococcus	Bacteria_Cyanobacteria
Propionibacterium	Bacteria_Actinobacteria
Pseudanabaena	Bacteria_Cyanobacteria
Pseudogulbenkiania	Bacteria_Betaproteobacteria
Pseudomonas	Bacteria_Gammaproteobacteria
Pseudoramibacter	Bacteria_Firmicutes
Pseudovibrio	Bacteria_Alphaproteobacteria
Pseudoxanthomonas	Bacteria_Gammaproteobacteria
Pyramidobacter	Bacteria_Synergistia
Pyrobaculum	Archaea_TACK
Pyrococcus	Archaea_Euryarchaeota
Pyropia	Rhodophyta_Bangiophyceae
Ralstonia	Bacteria_Betaproteobacteria
Rattus	Opisthokonta_Metazoa_Eumetazoa_Bilateria
Rhodobacter	Bacteria_Alphaproteobacteria
Rhodomicrobium	Bacteria_Alphaproteobacteria
Rhodopirellula	Bacteria_PVC group_Planctomycetes
Rhodopseudomonas	Bacteria_Alphaproteobacteria
Rhodospirillum	Bacteria_Alphaproteobacteria
Rhodothermus	Bacteria_FCB group_Bacteroidetes
Rickettsia	Bacteria_Alphaproteobacteria
Rivularia	Bacteria_Cyanobacteria
Roseiflexus	Bacteria_Chloroflexi
Roseobacter	Bacteria_Alphaproteobacteria
Roseomonas	Bacteria_Alphaproteobacteria
Rubrobacter	Bacteria_Actinobacteria
Ruegeria	Bacteria_Alphaproteobacteria
Saccharophagus	Bacteria_Gammaproteobacteria
Saccharothrix	Bacteria_Actinobacteria
Salinarchaeum	Archaea_Euryarchaeota
Salinisphaera	Bacteria_Gammaproteobacteria
Salmonella	Bacteria_Gammaproteobacteria
Saprospira	Bacteria_FCB group_Bacteroidetes
Sargassum	SAR-Stramenopila_PX clade_Phaeophyceae
Scytonema	Bacteria_Cyanobacteria
Sebaldella	Bacteria_Fusobacteria
Selenomonas	Bacteria_Firmicutes
Shewanella	Bacteria_Gammaproteobacteria
Shigella	Bacteria_Gammaproteobacteria
Simkania	Bacteria_PVC group_Chlamydiae
Singulisphaera	Bacteria_PVC group_Planctomycetes
Sphaerobacter	Bacteria_Chloroflexi
Sphingobacterium	Bacteria_FCB group_Bacteroidetes
Sphingobium	Bacteria_Alphaproteobacteria
Spirochaeta	Bacteria_Spirochaetes
Spirulina	Bacteria_Cyanobacteria
Staphylococcus	Bacteria_Firmicutes
Stenotrophomonas	Bacteria_Gammaproteobacteria
Streptococcus	Bacteria_Firmicutes
Streptomyces	Bacteria_Actinobacteria
Succinatimonas	Bacteria_Gammaproteobacteria
Sulfolobus	Archaea_TACK
Sulfurihydrogenibium	Bacteria_Aquificae
Sulfurimonas	Bacteria_Epsilonproteobacteria
Sulfurospirillum	Bacteria_Epsilonproteobacteria
Synechococcus	Bacteria_Cyanobacteria
Synergistes	Bacteria_Synergistia
Syntrophobacter	Bacteria_Deltaproteobacteria
Syntrophus	Bacteria_Deltaproteobacteria
Taeniopygia	Opisthokonta_Metazoa_Vertebrata_birds
Teredinibacter	Bacteria_Gammaproteobacteria
Terrimicrobium	Bacteria_PVC group_Verrucomicrobia
Tetraodon	Opisthokonta_Metazoa_Vertebrata
Thalassospira	Bacteria_Alphaproteobacteria
Theileria	SAR-Apicomplexa
Thermanaerovibrio	Bacteria_Synergistia
Thermoanaerobacter	Bacteria_Firmicutes
Thermoanaerobacterium	Bacteria_Firmicutes
Thermococcus	Archaea_Euryarchaeota
Thermodesulfovibrio	Bacteria_Nitrospirae
Thermofilum	Archaea_TACK
Thermophagus	Bacteria_FCB group_Bacteroidetes
Thermoplasma	Archaea_Euryarchaeota
Thermosphaera	Archaea_TACK
Thermosynechococcus	Bacteria_Cyanobacteria
Thermotoga	Bacteria_Thermotogae
Thermovibrio	Bacteria_Aquificae
Thermus	Bacteria_Deinococcus
Thiorhodospira	Bacteria_Gammaproteobacteria
Toxoplasma	SAR-Apicomplexa
Treponema	Bacteria_Spirochaetes
Truepera	Bacteria_Deinococcus
Trypanosoma	Euglenozoa_Kinetoplastida
Turneriella	Bacteria_Spirochaetes
Verminephrobacter	Bacteria_Betaproteobacteria
Verrucomicrobium	Bacteria_PVC group_Verrucomicrobia
Vibrio	Bacteria_Gammaproteobacteria
Victivallis	Bacteria_PVC group_Lentisphaerae
Voromonas	SAR-Apicomplexa_Chromerida
Vulcanisaeta	Archaea_TACK
Waddlia	Bacteria_PVC group_Chlamydiae
Wolbachia	Bacteria_Alphaproteobacteria
Wolinella	Bacteria_Epsilonproteobacteria
Xanthomonas	Bacteria_Gammaproteobacteria
Yersinia	Bacteria_Gammaproteobacteria
Zymomonas	Bacteria_Alphaproteobacteria
Accumulibacter	Bacteria_Betaproteobacteria
Arthromitus	Bacteria_Firmicutes
Chlamydophila	Bacteria_PVC group_Chlamydiae
Cloacimonas	Bacteria_FCB group
Diapherotrites	Archaea_DPANN
Endolissoclinum	Bacteria_Alphaproteobacteria
Gracilibacteria	Bacteria_unclassified
Kuenenia	Bacteria_PVC group_Planctomycetes
Marinimicrobia	Bacteria_FCB group
Methanosaeta	Archaea_Euryarchaeota
Nitrolancetus	Bacteria_Chloroflexi
Pelagibacter	Bacteria_Alphaproteobacteria
Prasinophyceae	Viridiplantae_Chlorophyta_prasinophytes
Puniceispirillum	Bacteria_Alphaproteobacteria
Acyrthosiphon	Opisthokonta_Metazoa_Arthropoda
Amphimedon	Opisthokonta_Metazoa_Porifera
Apis	Opisthokonta_Metazoa_Arthropoda
Arthroderma	Opisthokonta_Fungi_Ascomycota
Asterochloris	Viridiplantae_Chlorophyta_Trebouxiophyceae
Babesia	SAR-Apicomplexa_Aconoidasida_Piroplasmida
Bombyx	Opisthokonta_Metazoa_Arthropoda
Bos	Opisthokonta_Metazoa_Vertebrata
Brachypodium	Viridiplantae_Streptophyta
Branchiostoma	Opisthokonta_Metazoa_Chordata
Coprinopsis	Opisthokonta_Fungi_Basidiomycota
Fusarium	Opisthokonta_Fungi_Ascomycota
Hydra	Opisthokonta_Metazoa_Cnidaria
Ixodes	Opisthokonta_Metazoa_Arthropoda
Komagataella	Opisthokonta_Fungi_Ascomycota
Lachancea	Opisthokonta_Fungi_Ascomycota
Leptomonas	Euglenozoa_Kinetoplastida
Loa	Opisthokonta_Metazoa_Eumetazoa_Nematoda
Lodderomyces	Opisthokonta_Fungi_Ascomycota
Loxodonta	Opisthokonta_Metazoa_Vertebrata
Malassezia	Opisthokonta_Fungi_Basidiomycota
Melampsora	Opisthokonta_Fungi_Basidiomycota
Nasonia	Opisthokonta_Metazoa_Arthropoda
Naumovozyma	Opisthokonta_Fungi_Ascomycota
Oryctolagus	Opisthokonta_Metazoa_Vertebrata
Pediculus	Opisthokonta_Metazoa_Arthropoda
Penicillium	Opisthokonta_Fungi_Ascomycota
Pisum	Viridiplantae_Streptophyta
Podospora	Opisthokonta_Fungi_Ascomycota
Populus	Viridiplantae_Streptophyta
Pristionchus	Opisthokonta_Metazoa_Nematoda
Pyrenophora	Opisthokonta_Fungi_Ascomycota
Ricinus	Viridiplantae_Streptophyta
Sarcophilus	Opisthokonta_Metazoa_Vertebrata
Sclerotinia	Opisthokonta_Fungi_Ascomycota
Sorghum	Viridiplantae_Streptophyta
Tetrapisispora	Opisthokonta_Fungi_Ascomycota
Tribolium	Viridiplantae_Streptophyta
Trichinella	Opisthokonta_Metazoa_Nematoda
Trichoderma	Opisthokonta_Fungi_Ascomycota
Trichomonas	Parabasalia
Ustilago	Opisthokonta_Fungi_Basidiomycota
Vitis	Viridiplantae_Streptophyta
Xenopus	Opisthokonta_Metazoa_Vertebrata
Zymoseptoria	Opisthokonta_Fungi_Ascomycota
Ashbya	Opisthokonta_Fungi_Ascomycota
Quahog	SAR-Stramenopila_some-oomycete
Bicosoecid	SAR-Stramenopila_bicosoecida